width 20
height 15
tileWidth 32
tileHeight 32
layout
0 0 0 0 0 0 0 0 0 0 0 0 0 0 0 0 0 0 0 0
0 0 0 0 0 0 0 0 0 0 0 0 0 0 0 0 0 0 0 0
0 0 0 0 0 0 0 0 0 0 0 3 0 0 0 0 0 0 0 0
0 0 0 1 1 1 1 1 1 1 1 1 1 1 0 0 0 0 0 0
0 0 0 0 0 0 0 0 0 0 0 0 0 0 0 0 6 0 0 0
0 0 0 0 0 0 0 0 0 0 0 0 0 0 0 0 0 0 0 0
0 0 0 0 0 0 0 0 0 0 0 0 0 0 0 0 0 0 0 6
0 0 0 0 0 0 0 0 0 0 0 0 0 0 0 0 0 6 6 0
0 0 0 0 0 0 2 0 0 0 0 2 0 0 0 0 6 0 0 0
0 0 0 0 3 3 2 0 0 0 0 2 0 0 0 0 0 0 4 0
0 0 0 1 1 1 2 0 0 0 0 2 2 2 0 0 2 2 1 1
0 0 0 0 0 0 0 0 0 0 0 0 0 0 0 0 0 0 0 0
1 0 3 0 4 3 3 0 0 0 0 0 0 0 0 0 3 0 0 0
0 0 1 1 1 1 1 3 3 3 3 1 1 1 0 0 1 0 0 0
0 0 0 0 0 0 0 1 1 1 1 0 0 0 0 0 0 0 0 0